NO ./img/wall_1.xpm
SO ./img/wall_2.xpm
 WE ./img/wall_3.xpm
EA ./img/wall_4.xpm
F 51, 25 , 0  
C 158,250,85




        1111111111111111111111111
        100000000110000000000001
        1011000001110000000000001
        1001000000000000000000001
111111111011000001110000000000001
1000000000110000011101111101111111
11110111111111011100000010001
11110111111111011101010010001
11000000110101011100000010001
10000000000000001100N00010001
10000000000000001101010010001
11000001110101011111011110011
11110111 1110101 101111010001
11111111 1111111 111111111111
